1111111
1C00001
100M001
1P000E1
1111111