111111111111111111111
1CM000CCCC00MM00000C1
1000101000000001C0011
1P001E1000M0000CCCC01
111111111111111111111